{
  "<blank>": 0,
  " ": 1,
  "&": 2,
  "'": 3,
  ",": 4,
  "-": 5,
  ".": 6,
  "/": 7,
  "0": 8,
  "4": 9,
  "9": 10,
  ":": 11,
  ";": 12,
  "A": 13,
  "B": 14,
  "C": 15,
  "D": 16,
  "E": 17,
  "F": 18,
  "G": 19,
  "I": 20,
  "L": 21,
  "M": 22,
  "N": 23,
  "O": 24,
  "P": 25,
  "Q": 26,
  "R": 27,
  "S": 28,
  "T": 29,
  "U": 30,
  "W": 31,
  "a": 32,
  "b": 33,
  "c": 34,
  "d": 35,
  "e": 36,
  "f": 37,
  "g": 38,
  "h": 39,
  "i": 40,
  "k": 41,
  "l": 42,
  "m": 43,
  "n": 44,
  "o": 45,
  "p": 46,
  "q": 47,
  "r": 48,
  "s": 49,
  "t": 50,
  "u": 51,
  "v": 52,
  "w": 53,
  "x": 54,
  "y": 55,
  "z": 56,
  "¶": 57,
  "ł": 58,
  "̀": 59,
  "́": 60,
  "̃": 61,
  "̈": 62,
  "̧": 63,
  "̾": 64,
  "ͣ": 65,
  "ͤ": 66,
  "ͥ": 67,
  "ͭ": 68,
  "ᵈ": 69,
  "᷑": 70,
  "ᷤ": 71,
  "⁊": 72,
  "ꝑ": 73,
  "ꝓ": 74,
  "ꝙ": 75,
  "ꝯ": 76,
  "ꝰ": 77,
  "ꝵ": 78,
  "": 79
}